****************************************
A--------------*-----------*-----------*
***-*****-****-**********-**************
*-----*-----*------*-------------------*
*-*****-*********-***-******************
*-*-------*-------*---*----------------*
*-*********-*********-******************
*--------------*--------------------*--*
************-***************-***********
*------------*----------------*--------*
*********-************-*****************
*--------------*--------------*--------*
***-*************-**********************
*-----*--------*-----------------*-----*
*-*******-********-**********-**********
*-------*---------*---*--------*-------*
*-**************--***-******************
*--------------*-----*-----------------*
*******-*************************-******
*-----------------*--------*-----------*
*******-**********-**********-**********
*--------------*--------*--------------*
**********************************-*****
*-----------------*--------------------*
*********-******************-***********
*---------*----------*------------------
********--********************-*********
*-----------------*--------*-----------*
********-*******************************
*-------------------------------------B*
****************************************