********************
A-------*---*------B
*****-*******-******
*-----*------------*
*-*****-******-*****
*---*----------*---*
***-*****-****-*****
*---*---*------*--**
*-***-***-**********
*---*---*-------****
***-*-*********-****
*---*--*--------****
***-****-*****-*****
*------------*---***
*-**********-*******
*---*--------*---***
***-*****-*******-**
*-----*----------***
***-*************-**
*------------------*
********************