****************************************
*--------------*--------------------B-**
*-************-*****************-*******
*--------------*-------------------*****
***-*********-*******-**********-*******
*-----*-----------------------*--------*
***-***-*******-*******-*******-********
*-----*-----*-----------*-------------**
*****-*****-*******-**********-*********
*------*-----***--------*------------***
*-******-*******-*********-*************
*------*---**--------*---*------------**
***-*****-***-*****-***-*****-**********
*-----*-----------*-----*-----*-------**
*-*****-*********-*********-************
*-*---*---*-------------*-------------**
*-*-***-***-**********-*************-***
*-*---*---*---------*----------------***
*-***-***-*******-*******-**************
*-*-----*---*-----------------*------***
*-*********-*******************-********
*A------------------------------------**
****************************************