********************
*A----*---*--------*
*****-*******-******
*------------------*
*-*****-******-*****
*---*----------*---*
***-****-*****-*****
*---*---*------*--**
*-***-***-**********
*---*---*-------****
***-*-*********-****
*---*---*-------****
***-****-*****-*****
*------------*---***
*-**********-*******
*---*--------*---***
***-*****-*******-**
*-----*-----------**
***-*************-**
*------------------B
********************